WWWWWWWWWWW
WWWWWEWWWWW
WW.......WW
W.RR...RR.W
W...RRR...W
W.R.....R.W
W..RRRRR..W
W.........W
W....P....W
W.........W